..................................................
..................................................
..................................................
..................................................
..................................................
..................................................
..................................................
...............#################..................
...............................#..................
...............................#..................
...............................#..................
...............................#..................
...............................#..................
...################............#..................
............#..................#..................
............#..................#..................
............#..................#..................
............#..................#..................
...............................#..................
..................................................
..................................................
...........#####################...........#......
...........................................#......
...........................................#......
...........................................#......
...........................................#......
...........................................#......
..........#################...............#.......
.........................................#........
........................................#.........
..................................................
..................................................
..................................................
..................................................
............#################.....................
...........................#......................
...........................#......................
...........................#......................
...........................#......................
..................................................
..................................................
..................................................
..................................................
..................................................